15 10
##########
#
#
# #### # #
# #
# #
# # ## # #
# # ## # #
# # ## # #
# # #### #
# #
#
# #&## ###
# # #
#
# #
# #
# ## ### #
#
#
##########
15 22
#####............#####
#
#............#
#
#
##############
#
#
#
#
##### ######
#
#
##### ##
#
# & ##### ## ###
#
#
##### ## ###
#
#
#####
###
#
#
############
#
####
#
#
....#
#
### #
.....#
###
#
......#####
#
#
...........###########